1111112111111411113411111111112111114111111141132111113111111111111311111111311411111311411111111111
3111111211111111111111121111111311111311111111111121111141111144111111111131114112111113111112111132
1111111113141111112111111111112411111111112111111111111111113111111111114111114111411211131111111111
1111111111132111111111111111111111111114111131111141111111111111111111111111142111111111111311111111
1311111121111113112411121111111131111111111111111111111111131411111141121111111111111111111111111111
3111132111133111111111111111313111111111111131141111114114111111141111411111111111111111111113111111
1111111111111111311111111111111121111111113111411111111111111111111111111111111111113111111111111111
1111111111311111112111111111111211113111111121111111111111111142211111111111111311111111111111111111
1111111111111111111111211111111111111111121111411111111111111111111111131111111111111111212114111111
1131111111111131111111111114111111111114111111211121111111111121311112111111111111111111111111211111
1111111111111111111111111211111111111114111134111111142111111111111111111111211111111111411111211114
1131111111211111213121111111131131111114111111111114111113111111121114141314341111311111113111111111
1112111111111111111111111111311111113111111111211111111112111113111113112131111411111111111111214111
1111111111111111113111113111111111111111113121111111111111111111111111111112111111111111111113114111
1111111113311211111121141111114112111111111111111111111111111111111111411121114131131111111111112111
1111111131111111111111111111111111111111111111111111111311113111114131211211111111111111412111111311
3111113111111121111111111211111111111111111131111111411111111111111111133111111111111111411111111111
1111111411111111111111111131111111111111111134111111111111111111111111111111111111111141111111111114
1111111111111111111111311111111111111111111111111111141111111111111111111211311311111112111141111111
1111111411111111111111111111111114111121111121111111141241111111111111111111113113112111113111211112
1111111111111111131111111131111113111111311111111111111111111111411111131131111111113111211111113131
1111112112111111411111111411111111111111111113114141111111111211111211114211111111411121111111111121
1311211111311111111111111111111111111111141111111111111121111121113111211113111111113112111111111111
1111111112111111111111111111111141211121111111111111111111411131411111131311111111111111111111411112
1111111111111112111121111141123111121121112111111111111111111111111111111111111111211111113211111111
1111111113111111111111111111111131111114411111421111111111111111111111111111431131111111111111111111
1111111111111141111111111111111111111111112111111111131112111111141111411111111111111111112111111111
1111111141111111111111311111111111111121111131111111111111111122113114311111111114111111111113111111
1111114111111111111111211121111111111141111211111111111111111111111111111111141111111111143111111111
2131111111111134111111111111121141131111111111111111111111111134112111211111111111111111111114111111
1111111141111111111111111111121111111131111111111113111121111111111111111111111111111111111111111411
1111111111111111113111111111441111111314111211111111133221141112111114111111111111111111141211111131
1111111111111111112111111141112111111111111111111111111111111111112233111111112111111111111111111111
1112131111211111111112111111111111111111111111121413141111141111111111111111211111111111111111111111
1111111411111111141111111141111111111141111111111111131111111111113311111111311111111111111114111111
1111111111132113111131111321111111111211411111141111111121211111111111111111111111141111211111111111
1113111411111131111111111111111111111211111111111111111111111111113111111111111111111111111111111111
1111311111111111111111113111111111113111111131112131111111111111114114411111111111112111111111111121
1111111111111311111111111111112111111113111311111113111121111111111111111141111131141111211111111211
1111111111311111111111131111111111111111111121111111111131111111111111111111111111111111111111111111
1111111111411111314112114111411114113111111113111113111411111111111111111111241111111111111111111311
4111111121131113311111111111111211114111111111111111111311111111111111111111111111111111111411412111
1121111111141411111111111131111414111111111111111111111111111111111311111311111111111111144111111111
1111111141112111111111111111121411111111113112111113114111111111111111111141111111111312111114111111
1111131131111111342111111111111111212111142131111111111111111111111111111111111111411121113111111111
1111141311111111111311111211111111321111141111111112111111111111111111111131113111211311112111141311
1121111111411111111111111411411111111111111111111411111111111111131111111111113111113111111111111121
1111411211111111111111111111112111111111111111111111111111111113111111411111111411111111111312111111
1112111111111111442111111111111111111111111111112111211113114111111111111111111311111121111111131111
1311111111111111111111114111111411132113211111111211131111114113421121111111111414111111111111311113
1111211111111111114111111411211411114121111131111111111111311411111111111111114111111311141111111111
1111111111111111111111131111211111111111111121111114131111111132111111112113111311111111111111113111
1111112111131111114111111111113114111111111111111411113111111411111131111141211111111211111111111111
1111111111211111311111111111111111121113111111111112112111111141111114111411111111111121114111111411
1111111111114111111111111111111141111111131111111111121131141311211111411111131111111111111111431111
4111214111111111111111121111133111111111311111111111211111111111111111111111111111111111111112111111
1111111111111111111111111111113211111411111111313111111114111113111111111131211111111111111111111111
1111111111111111111111111111111211131111113111111111121111111111411131121111111111111111111111124141
1111111111111111411111111111111113111111111113111131111111111211111111113111111121111111111211111111
1111211111111111111111111111111113134141111111111111111111111111111111111431111111131411211111111111
1111111111111121413111111111111111111111111111114111121111111211111111111111411111111134111111111111
1111111111113111111111411112111111111111113111111121111111111111111111131111111311111113311111111111
1114141111111111111211111111111131111111111141311111111111111111114111111111111113111111111121114111
1111311111111111111111114111111121111111141111111311111141111134111111211411141111114111111111111111
1111111111133121111111111141111111111111111111113131131111111111111111112111211111111111111111111411
1111111111111111111111112111111111111111111312311131111411111131111211111111111113111111111112411311
1111111411111341111111111111211131111111111111113111411111111141411111111111111111211111111111111141
1111111111111111111111111111114111111111111111111111111111141111211111111311111111111111111111114111
1111111111111111111211111111111131111111112111111133111211111111141131111111111111111111111111111411
1121111111113111111113311111111111111111111111111121111112143111111114111111111111111111111111111111
4111141111111111111111141111111111111111111121411111111121111212111111111111111111441441111111114111
1111111111111111111111111141111121111311111111111113141111132113111231414111111111111111111111111111
1111112111214111121311112111111131111111111111111111141141211121311111111112241111111111114111111111
2111111111111112111311111131111111111111111111111111111114111111111121111411111111111111111111112111
1111111111111111111111111111111111112111111111111111111111111111111111121141111111111131111111111211
1111111131111112111111111111311113111311111243111113411111111111111111111111111111111111311111111311
1111111131411111121131131111411111111411111111121111111111111141113111121111141121141111111111111111
1111131111411121111111131111111313111121112114111111111111211111111111111112111111111111111131111411
1111111111111431121111111111111211113111111213111111114111111111112111121111111141111111111141111111
1111111144111111211111111111111111311111111111111111111111111111212113111141111141141111211111111111
4111111111111111112111111111111111111111411111111111113111311111111111111111111111111113141111111121
1113111111111211111111111111111331111111113111111111111111111111111411111111111111111111111111111111
1131211111111111411111111131111211111111411311111111111131121111111114111111112111111111111311111111
1111111111111113111111111112111111111122111111111111211121411111111111111211111111111111111211111111
1111111133111141121141111111111211111111121111111311311111111111111111113111111111111111313111111111
1411111141111111111111111114211111114111111111111111311111311111111131111113411131111111111111111311
1113111111121111111111111111111111112111111111112111112111121111141111111111111111114111111111121111
1111111111111141111111111111311111111113113111111111111111121111411111114111111111111211111141111112
1111111121111111111111111111211111111111131113111121111111111111111111111111111111111111111111111131
1111111111111111111111111111111411111411111111111411211111111111111111111111111121111311111111111131
1111111111111411121111111111111131131114111111112111113111111111113111111131114111111111111121113111
1111112111111111211111111111111111111111111111131141111211111111111111111211111111111111111111111111
1121111142111111231111111111341111121121111131121112111111111111111111113121111111111111411111111111
1111121111111111111111111114211111111131112111111111111111111111111111111211111112111111111111111114
1211111111111111111111111111111111111311111111111111111211121111111141111113111111111111111111111111
1111111111211111111112111311421111112211311211111311111111111111111111111111111111111111113411411114
1111111411111111111112111111111111111131111111111113111111141111111131111111111121311111111112111111
1111111111141111113111111111111111111111114111111341111111111111111111111211111311112111311111111111
1111111311111113411111114111111111141111111111111111411311111111111311111111111111111113111111114111
1111111111111111142131111111111111111111111141111113111111121111111141111111113114111111141111111114